NO textures/wall_texture_north.xpm
SO textures/wall_texture_south.xpm
WE textures/wall_texture_west.xpm
EA textures/wall_texture_east.xpm

F 18,53,25
C 153,204,255

  1111111111
 1        11
1          1
1      11111
10S000000001
111111111111
11         1
111111111111
